111111111111111
100002200000021
100000011000001
111000200200111
100000000000001
111111111111111
